ajdt            = eclipse.technology.ajdt
alf             = eclipse.technology.alf
amw             = eclipse.modeling.gmt.amw
aperi           = eclipse.technology.aperi
apogee          = eclipse.technology.apogee
atf             = eclipse.webtools.atf
birt            = eclipse.birt
bpel-designer   = eclipse.technology.bpel-designer
buckminster     = eclipse.technology.buckminster
buckminster-dev = eclipse.technology.buckminster-dev
cdt             = eclipse.tools.cdt
commercial      = eclipse.commercial
corona          = eclipse.technology.corona
cosmos          = eclipse.technology.cosmos
dali            = eclipse.technology.dali
dash            = eclipse.technology.dash
dd              = eclipse.dsdp.dd
dltk            = eclipse.technology.dltk
dsdp            = eclipse.dsdp
dtp             = eclipse.dtp
ecf             = eclipse.technology.ecf
emf             = eclipse.tools.emf
emft            = eclipse.technology.emft
employment      = eclipse.employment
eodm            = eclipse.modeling.mdt.eodm
epf             = eclipse.technology.epf
equinox         = eclipse.technology.equinox
ercp            = eclipse.dsdp.ercp
foundation      = eclipse.foundation
g-eclipse       = eclipse.technology.g-eclipse
gef             = eclipse.tools.gef
gmf             = eclipse.modeling.gmf
gmt             = eclipse.modeling.gmt
higgins         = eclipse.technology.higgins
jdt             = eclipse.tools.jdt
jsf             = eclipse.webtools.jsf
jwt             = eclipse.technology.jwt
linuxtools      = eclipse.technology.linuxtools
newcomer        = eclipse.newcomer
m2m             = eclipse.modeling.m2m
m2t             = eclipse.modeling.m2t
modeling        = eclipse.modeling
modisco         = eclipse.modeling.gmt.modisco
mddi            = eclipse.technology.mddi
mdt             = eclipse.modeling.mdt
mtj             = eclipse.dsdp.mtj
mylar           = eclipse.technology.mylar
nab             = eclipse.dsdp.nab
nebula          = eclipse.technology.nebula
ocl             = eclipse.modeling.mdt.ocl
ohf             = eclipse.technology.ohf
orbit           = eclipse.tools.orbit
packaging       = eclipse.technology.packaging
phoenix         = eclipse.technology.phoenix
php             = eclipse.tools.php
platform        = eclipse.platform
rap             = eclipse.technology.rap
rcp             = eclipse.platform.rcp
subversive      = eclipse.technology.subversive
swt             = eclipse.platform.swt
technology      = eclipse.technology
tm              = eclipse.dsdp.tm
tptp            = eclipse.tptp
uml2            = eclipse.modeling.mdt.uml2
uml2tools       = eclipse.modeling.mdt.uml2tools
ve              = eclipse.tools.ve
voicetools      = eclipse.technology.voicetools
webtools        = eclipse.webtools
xsd             = eclipse.modeling.mdt.xsd
